load_level =
###########################
#.........................#
#.........................#
#.........................#
#.........................#
#..........@..............#
#.........................#
#.........................#
#.........................#
#.........................#
#.........................#
#.........................#
###########################
